border_size=1
usage=map

Qxe, Qxe, Qxe, Qxe, Qxe, Qxe, Qxe, Qxe, Qxe, Qxe, Qxe, Qxe, Qxe, Qxe, Qxe, Qxe, Qxe, Qxu^Bcx|, Qxu^Bcx|, Qxu^Bcx|, Qxe, Qxe, Qxe, Qxe, Qxe, Qxe, Qxu, Qxu, Qxu, Qxu, Qxu, Qxe, Qxe, Qxe, Qxe, Qxe, Qxe, Qxe, Qxe, Qxe, Qxe, Qxe, Qxe, Qxe, Qxe, Qxe
Qxe, Qxe, Qxe, Qxe, Qxe, Qxe, Qxe, Qxe, Qxe, Qxe, Qxe, Qxe, Qxe, Qxe, Qxe, Qxe, Qxe, Qxu^Bcx|, Qxu^Bcx|, Qxu^Bcx|, Qxe, Qxe, Qxe, Qxe, Qxe, Qxe, Qxu, Qxu, Qxu, Qxu, Qxu, Qxe, Qxe, Qxe, Qxe, Qxe, Qxe, Qxe, Qxe, Qxe, Qxe, Qxe, Qxe, Qxe, Qxe, Qxe
Qxe, Qxe, Qxe, Qxe, Qxe, Qxe, Qxe, Qxe, Qxe, Qxe, Qxe, Qxe, Qxe, Qxe, Qxe, Qxe, Qxe, Qxu^Bcx|, Qxu^Bcx|, Qxu^Bcx|, Qxe, Qxe, Qxe, Qxe, Qxe, Qxe, Qxu, Qxu, Qxu, Qxu, Qxu, Qxu, Qxu, Qxe, Qxe, Qxe, Qxe, Qxe, Qxe, Qxe, Qxe, Qxe, Qxe, Qxe, Qxe, Qxe
Qxe, Qxe, Qxe, Qxe, Qxe, Qxe, Qxe, Qxe, Qxe, Qxe, Qxe, Qxe, Qxe, Qxe, Qxe, Qxe, Qxe, Qxu^Bcx|, Qxu^Bcx|, Qxu^Bcx|, Qxe, Qxe, Qxe, Qxe, Qxe, Qxe, Qxu, Qxu, Qxu, Qxu, Qxu, Qxu, Qxu, Qxe, Qxe, Qxe, Qxe, Qxe, Qxe, Qxe, Qxe, Qxe, Qxe, Qxe, Qxe, Qxe
Qxe, Qxe, Qxe, Qxe, Qxe, Qxe, Qxe, Qxe, Qxe, Qxe, Qxe, Qxe, Qxe, Qxe, Qxe, Qxe, Qxe, Qxu^Bcx|, Qxu^Bcx|, Qxu^Bcx|, Qxe, Qxe, Qxe, Qxe, Qxe, Qxe, Qxe, Qxu, Qxu, Qxu, Qxu, Qxu, Qxu, Qxe, Qxe, Qxe, Qxe, Qxe, Qxe, Qxe, Qxe, Qxe, Qxe, Qxe, Qxe, Qxe
Qxe, Qxe, Qxe, Qxe, Qxe, Qxe, Qxe, Qxe, Qxe, Qxe, Qxe, Qxe, Qxe, Qxe, Qxe, Qxe, Qxe, Qxu^Bcx|, Qxu^Bcx|, Qxu^Bcx|, Qxe, Qxe, Qxe, Qxe, Qxe, Qxe, Qxu, Qxu, Qxu, Qxu, Qxu, Qxu, Qxu, Qxe, Qxe, Qxe, Qxe, Qxe, Qxe, Qxe, Qxe, Qxe, Qxe, Qxe, Qxe, Qxe
Qxe, Qxe, Qxe, Qxe, Qxe, Qxe, Qxe, Qxe, Qxe, Qxe, Qxe, Qxe, Qxe, Qxe, Qxe, Qxe, Qxe, Qxu^Bcx|, Qxu^Bcx|, Qxu^Bcx|, Qxe, Qxe, Qxe, Qxe, Qxe, Qxe, Qxu, Qxu, Qxu, Qxu, Qxu, Qxu, Qxu, Qxe, Qxe, Qxe, Qxe, Qxe, Qxe, Qxe, Qxe, Qxe, Qxe, Qxe, Qxe, Qxe
Qxe, Qxe, Qxe, Qxe, Qxe, Qxe, Qxe, Qxe, Qxe, Qxe, Qxe, Qxe, Qxe, Qxe, Qxe, Qxe, Qxe, Qxu^Bcx|, Qxu^Bcx|, Qxu^Bcx|, Qxe, Qxe, Qxu, Qxe, Qxu, Qxu, Qxu, Qxu, Qxu, Qxu, Qxu, Qxu, Qxu, Qxe, Qxe, Qxe, Qxe, Qxe, Qxe, Qxe, Qxe, Qxe, Qxe, Qxe, Qxe, Qxe
Qxe, Qxe, Qxe, Qxe, Qxe, Qxe, Qxe, Qxe, Qxe, Qxe, Qxe, Qxe, Qxe, Qxe, Qxe, Qxe, Qxe, Qxu^Bcx|, Qxu^Bcx|, Qxu^Bcx|, Qxu, Qxu, Qxu, Qxu, Qxu, Qxu, Qxu, Qxu, Qxu, Qxu, Qxu, Qxu, Qxu, Qxe, Qxe, Qxe, Qxe, Qxe, Qxe, Qxe, Qxe, Qxe, Qxe, Qxe, Qxe, Qxe
Qxe, Qxe, Qxe, Qxe, Qxe, Qxe, Qxe, Qxe, Qxe, Qxe, Qxe, Qxe, Qxe, Qxe, Qxe, Qxe, Qxe, Qxu^Bcx|, Qxu^Bcx|, Qxu^Bcx|, Qxu, Qxu, Qxu, Qxu, Qxu, Qxu, Qxu, Qxu, Qxu, Qxu, Qxu, Qxu, Qxu, Qxe, Qxe, Qxe, Qxe, Qxe, Qxe, Qxe, Qxe, Qxe, Qxe, Qxe, Qxe, Qxe
Qxe, Qxe, Qxe, Qxe, Qxe, Qxe, Qxe, Qxe, Qxe, Qxe, Qxe, Qxe, Qxe, Qxe, Qxe, Qxe, Qxe, Qxu^Bcx|, Qxu^Bcx|, Qxu^Bcx|, Qxu, Qxu, Qxu, Qxu, Qxu, Qxu, Qxu, Qxu, Qxu, Qxu, Qxu, Qxu, Qxe, Qxe, Qxe, Qxe, Qxe, Qxe, Qxe, Qxe, Qxe, Qxe, Qxe, Qxe, Qxe, Qxe
Qxe, Qxe, Qxe, Qxe, Qxe, Qxe, Uue, Qxe, Qxe, Qxe, Qxe, Qxe, Qxe, Qxe, Qxe, Qxe, Qxe, Qxu^Bcx|, Qxu^Bcx|, Qxu^Bcx|, Qxu, Qxu, Qxu, Qxu, Qxu, Qxu, Qxe, Qxe, Qxe, Qxu, Qxe, Qxe, Qxe, Qxe, Qxe, Qxe, Qxe, Qxe, Qxe, Qxe, Qxe, Qxe, Qxe, Qxe, Qxe, Qxe
Uue, Uue, Uue, Uue, Uue, Uue, Uue, Uue, Uue, Qxe, Qxe, Qxe, Qxe, Qxe, Uue, Uh, Uue, Qxu^Bcx|, Qxu^Bcx|, Qxu^Bcx|, Qxe, Qxu, Qxu, Qxu, Qxe, Qxe, Qxe, Qxe, Qxe, Qxe, Qxe, Qxe, Qxe, Qxe, Qxe, Qxe, Qxe, Qxe, Qxe, Qxe, Qxe, Qxe, Qxe, Qxe, Qxe, Qxe
Uue, Uue, Uue, Uue, Uue, Uue, Uue, Uue, Uh, Uue, Uue, Uue, Uue, Uue, Uue, Uue, Uue, Uue, Qxu^Bcx|, Qxu^Bcx|, Qxe, Qxe, Qxe, Qxe, Qxe, Qxe, Qxe, Qxe, Qxe, Qxe, Qxe, Qxe, Qxe, Qxe, Qxe, Qxe, Qxe, Qxe, Qxe, Qxe, Qxe, Qxe, Qxe, Qxe, Qxe, Qxe
Uue, Uue, Uue, Uue, Uue, Uue, Uue, Uue, Uue, Uue, Uue, Uue, Qxe, Qxe, Qxe, Uh, Qxe, Uue, Qxu^Bcx|, Qxu^Bcx|, Qxe, Qxe, Qxe, Qxe, Qxe, Qxe, Qxe, Qxe, Qxe, Qxe, Qxe, Qxe, Qxe, Qxe, Qxe, Qxe, Qxe, Qxe, Qxe, Qxe, Qxe, Qxe, Qxe, Qxe, Qxe, Qxe
Qxe, Qxe, Qxe, Qxe, Qxe, Uue, Uue, Uue, Qxe, Qxe, Qxe, Qxe, Qxe, Qxe, Qxe, Qxe, Qxe, Qxu^Bcx|, Qxu^Bcx|, Qxu^Bcx|, Qxe, Qxe, Qxe, Qxe, Qxe, Qxe, Qxe, Qxe, Qxe, Qxe, Qxe, Qxe, Qxe, Qxe, Qxe, Qxe, Qxe, Qxe, Qxe, Qxe, Qxe, Qxe, Qxe, Qxe, Qxe, Qxe
Qxe, Qxe, Qxe, Qxe, Qxe, Qxe, Qxe, Qxe, Qxe, Qxe, Qxe, Qxe, Qxe, Qxe, Qxe, Qxe, Qxe, Qxu^Bcx|, Qxu^Bcx|, Qxu^Bcx|, Qxe, Qxe, Qxe, Qxe, Qxe, Qxe, Qxe, Qxe, Qxe, Qxe, Qxe, Qxe, Qxe, Qxe, Qxe, Qxe, Qxe, Qxe, Qxe, Qxe, Qxe, Qxe, Qxe, Qxe, Qxe, Qxe
Qxe, Qxe, Qxe, Qxe, Qxe, Qxe, Qxe, Qxe, Qxe, Qxe, Qxe, Qxe, Qxe, Qxe, Qxe, Qxe, Qxe, Qxu^Bcx|, Qxu^Bcx|, Qxu^Bcx|, Qxe, Qxe, Qxe, Qxe, Qxe, Qxe, Qxe, Qxe, Qxe, Qxe, Qxe, Qxe, Qxe, Qxe, Qxe, Qxe, Qxe, Qxe, Qxe, Qxe, Qxe, Qxe, Qxe, Qxe, Uu^Emf, Qxe
Qxe, Qxe, Qxe, Qxe, Qxe, Qxe, Qxe, Qxe, Qxe, Qxe, Qxe, Qxe, Qxe, Qxe, Qxe, Qxe, Qxe, Qxu^Bcx|, Qxu^Bcx\, Qxu^Bcx\, Qxu^Bcx\, Qxe, Qxe, Qxe, Qxe, Qxe, Qxe, Qxe, Qxe, Qxe, Qxe, Qxe, Qxe, Qxe, Qxe, Qxe, Qxe, Qxe, Qxe, Qxe, Qxe, Qxe, Qxe, Uu^Emf, Uu^Emf, Uu^Emf
Qxe, Qxe, Uu, Uu, Uu, Qxe, Qxe, Qxe, Qxe, Qxe, Qxe, Qxe, Qxe, Qxe, Qxe, Qxe, Qxe, Qxu^Bcx\, Qxu^Bcx\, Qxu^Bcx\, Qxu^Bcx\, Qxu^Bcx\, Qxu^Bcx\, Qxe, Qxe, Qxe, Qxe, Qxe, Qxe, Qxe, Qxe, Qxe, Qxe, Qxe, Qxe, Qxe, Qxe, Qxe, Qxe, Qxe, Qxe, Qxe, Qxe, Uu, Uu, Uu^Emf
Uu, Uu, Uu, Uu, Uu, Uu, Qxe, Qxe, Qxe, Qxe, Qxe, Qxe, Qxe, Qxe, Qxe, Qxe, Qxe, Qxe, Qxe, Qxu^Bcx\, Qxu^Bcx\, Qxu^Bcx\, Qxu^Bcx\, Qxu^Bcx\, Qxu^Bcx\, Qxe, Qxe, Qxe, Qxe, Qxe, Qxe, Qxe, Qxe, Qxe, Qxe, Qxe, Qxe, Qxe, Qxe, Qxe, Qxe, Qxe, Qxu^Bcx/, Uu, Uu, Uu
Uu, Uu, Uu, Uu, Uu, Uu, Qxe, Qxe, Qxe, Qxe, Qxe, Qxe, Qxe, Qxe, Qxe, Qxe, Qxe, Qxe, Qxe, Qxe, Qxe, Qxu^Bcx\, Qxu^Bcx\, Qxu^Bcx\, Qxu^Bcx\, Qxu^Bcx\, Qxu^Bcx\, Qxe, Qxe, Qxe, Qxe, Qxe, Qxe, Qxe, Qxe, Qxe, Qxe, Qxe, Qxe, Qxe, Qxu^Bcx/, Qxu^Bcx/, Qxe, Uu, Uu, Uu
Uu, Uu, Uu, Uu, Uu, Uu, Qxe, Qxe, Qxe, Qxe, Qxe, Qxe, Qxe, Qxe, Qxe, Qxe, Qxe, Qxe, Qxe, Qxe, Qxe, Qxe, Qxe, Qxu^Bcx\, Qxu^Bcx\, Qxu^Bcx\, Qxu^Bcx\, Qxu^Bcx\, Qxu^Bcx\, Qxe, Qxe, Qxe, Qxe, Qxe, Qxe, Qxe, Qxe, Qxe, Qxu^Bcx/, Qxu^Bcx/, Qxe, Qxe, Qxe, Uu^Emf, Uu^Emf, Uu
Uu, Uu, Uu, Uu, Uu, Uu, Uu, Qxe, Qxe, Qxe, Qxe, Qxe, Qxe, Qxe, Qxe, Qxe, Qxe, Qxe, Qxe, Qxe, Qxe, Qxe, Qxe, Qxe, Qxe, Qxu^Bcx\, Qxu^Bcx\, Qxu^Bcx\, Qxu^Bcx|, Qxu^Bcx\, Qxe, Qxe, Qxe, Qxe, Qxe, Qxe, Qxu^Bcx/, Qxu^Bcx/, Qxe, Qxe, Qxe, Qxe, Qxe, Uu^Emf, Uu^Emf, Uu^Emf
Uu, Uu, Uu^Vu, Uu, Uu, Uu, Uu, Uu, Uu, Qxe, Qxe, Qxe, Qxe, Qxe, Qxe, Qxe, Qxe, Qxe, Qxe, Qxe, Qxe, Qxe, Qxe, Qxe, Qxe, Qxe, Qxe, Uue, Uue, Qxu^Bcx|, Qxe, Qxe, Qxe, Qxe, Qxu^Bcx/, Qxu^Bcx/, Qxe, Qxe, Qxe, Qxe, Qxe, Qxe, Qxe, Qxe, Qxe, Qxe
Uu, Uu, Uu, Uu, Uu, Uu, Uu, Uu, Uu, Qxe, Qxe, Qxe, Qxe, Qxe, Qxe, Qxe, Qxe, Qxe, Qxe, Qxe, Qxe, Qxe, Qxe, Qxe, Qxe, Qxe, Qxe, Uue^Ii, Qxu^Bcx|, Uue, Qxe, Qxe, Qxu^Bcx/, Qxu^Bcx/, Qxe, Qxe, Qxe, Qxe, Qxe, Qxe, Qxe, Qxe, Qxe, Qxe, Qxe, Qxe
Uu, Uu, Uu, Uu, Ce, Uu, Uu, Uu^Vu, Uu, Uu, Qxe, Qxe, Qxe, Qxe, Qxe, Qxe, Qxe, Qxe, Qxe, Qxe, Qxe, Qxe, Qxe, Qxe, Qxe, Qxe, Qxe, Qxu^Bcx|, Qxu^Bcx|, Qxu^Bcx|, Qxu^Bcx/, Qxu^Bcx/, Qxe, Qxe, Qxe, Qxe, Qxe, Qxe, Qxe, Qxe, Qxe, Qxe, Qxe, Qxe, Qxe, Qxe
Uu, Uu, Uu, Ce, Ket, Ce, Uu, Uu, Uu, Uu, Qxe, Qxe, Qxe, Qxe, Qxe, Qxe, Qxe, Qxe, Qxe, Qxe, Qxe, Qxe, Qxe, Qxe, Qxe, Qxe, Qxe, Qxu^Bcx|, Qxu^Bcx|, Qxu^Bcx/, Qxe, Qxe, Qxe, Qxe, Qxe, Qxe, Qxe, Qxe, Qxe, Qxe, Qxe, Qxe, Qxe, Qxe, Qxe, Qxe
Uu, Uu, Uu, Ce, Ce, Ce, Uu, Uu, Uu, Uu, Qxu^Bp\, Qxe, Qxe, Qxe, Qxe, Qxe, Qxe, Qxe, Qxe, Qxe, Qxe, Qxe, Qxe, Qxe, Qxe, Qxe, Qxe, Qxu^Bcx|, Qxu^Bcx|, Qxu^Bcx|, Qxe, Qxe, Qxe, Qxe, Qxe, Qxe, Qxe, Qxe, Qxe, Qxe, Qxe, Qxe, Qxe, Qxe, Qxe, Qxe
Uu, Uu, Uu^Vu, Uu, Uu, Uu, Uu, Uu, Uu, Qxu^Bp\, Qxu^Bp\, Qxu^Bp\, Qxu^Bp\, Qxe, Qxe, Qxe, Qxe, Qxe, Qxe, Qxe, Qxe, Qxe, Qxe, Qxe, Qxe, Qxe, Qxe, Qxu^Bcx|, Qxu^Bcx|, Qxu^Bcx|, Qxe, Qxe, Qxe, Qxe, Qxe, Qxe, Qxe, Qxe, Qxe, Qxe, Qxe, Qxe, Qxe, Qxe, Qxe, Qxe
Uu, Uu, Uue, Uu, Uu, Uu, Uu, Uu, Uu, Qxu^Bp\, Qxu^Bp\, Qxu^Bp\, Qxu^Bp\, Qxu^Bp\, Qxu^Bp\, Qxe, Qxe, Qxe, Qxe, Qxe, Qxe, Qxe, Qxe, Qxe, Qxe, Qxe, Qxe, Qxu^Bcx|, Qxu^Bcx|, Qxu^Bcx|, Uue, Qxe, Qxe, Qxe, Qxe, Qxe, Qxe, Qxe, Qxe, Qxe, Qxe, Qxe, Qxe, Qxe, Qxe, Qxe
Uh, Uue, Uue, Uu, Uu, Uu^Vu, Uu, Uu, Uu, Qxe, Qxe, Qxu^Bp\, Qxu^Bp\, Qxu^Bp\, Qxu^Bp\, Qxu^Bp\, Qxu^Bp\, Qxe, Qxe, Qxe, Qxe, Qxe, Qxe, Qxe, Qxe, Qxe, Qxe, Qxu^Bcx|, Uue, Uue, Uue, Uue, Uue, Qxe, Qxe, Qxe, Qxe, Qxe, Qxe, Qxe, Qxe, Qxe, Qxe, Qxe, Qxe, Qxe
Uue, Uh, Uu, Uh, Uu, Uu, Uu, Uu, Uu, Qxe, Qxe, Qxe, Qxe, Qxu^Bp\, Qxu^Bp\, Qxu^Bp\, Qxu^Bp\, Qxu^Bp\, Qxu^Bp\, Qxe, Qxe, Qxe, Qxe, Qxe, Qxe, Qxe, Qxe, Qxu^Bcx|, Qxu^Bcx|, Uue, Uue, Uue, Uue, Uue, Uue, Qxe, Qxe, Qxe, Qxe, Qxe, Qxe, Qxe, Qxe, Qxe, Qxe, Qxe
Uh, Uu, Uu, Uue, Qxe, Uu, Uu, Uu, Qxe, Qxe, Qxe, Qxe, Qxe, Qxe, Qxe, Qxu^Bp\, Qxu^Bp\, Qxu^Bp\, Qxu^Bp\, Qxu^Bp\, Qxu^Bp\, Qxe, Qxe, Qxe, Qxe, Qxe, Qxe, Qxu^Bcx|, Qxu^Bcx|, Qxu^Bcx|, Qxe, Qxe, Qxe, Uue, Uue, Uue, Uue, Qxe, Uue, Qxe, Uue, Qxe, Uue, Uue, Uue, Uue
Uh, Uu, Uu, Uh, Qxe, Qxe, Qxe, Qxe, Qxe, Qxe, Qxe, Qxe, Qxe, Qxe, Qxe, Qxe, Qxe, Qxu^Bp\, Qxu^Bp\, Qxu^Bp\, Qxu^Bp\, Qxu^Bp\, Qxu^Bp\, Qxe, Qxe, Qxe, Qxe, Qxu^Bcx|, Qxu^Bcx|, Qxu^Bcx|, Qxe, Qxe, Qxe, Uue, Uue, Qxe, Qxe, Uue, Uue, Uue, Qxe, Uue, Qxe, Qxe, Qxe, Qxe
Uue, Uu, Uue, Uh, Qxe, Qxe, Qxe, Qxe, Qxe, Qxe, Qxe, Qxe, Qxe, Qxe, Qxe, Qxe, Qxe, Qxe, Qxe, Qxu^Bp\, Qxu^Bp\, Qxu^Bp\, Qxu^Bp\, Qxu^Bp\, Qxu^Bp\, Qxe, Qxu^Bcx/, Qxu^Bcx|, Qxu^Bcx/, Qxu^Bcx|, Qxe, Qxe, Qxe, Uue, Uue, Uue, Qxe, Uue, Uue, Qxe, Qxe, Qxe, Qxe, Qxe, Qxe, Qxe
Uh, Uue, Qxe, Qxe, Qxe, Qxe, Qxe, Qxe, Qxe, Qxe, Qxe, Qxe, Qxe, Qxe, Qxe, Qxe, Qxe, Qxe, Qxe, Qxe, Qxe, Qxu^Bp\, Qxu^Bp|, Qxu^Bp\, Qxu^Bp|, Qxu^Bcx/, Qxu^Bcx/, Qxu^Bcx/, Qxu^Bcx/, Qxu^Bcx/, Qxe, Qxe, Qxe, Uue, Uue, Qxe, Qxe, Uue, Uue, Uue, Uue, Qxe, Qxe, Qxe, Qxe, Qxe
Qxe, Qxe, Qxe, Qxe, Qxe, Qxe, Qxe, Qxe, Qxe, Qxe, Qxe, Qxe, Qxe, Qxe, Qxe, Qxe, Qxe, Qxe, Qxe, Qxe, Qxe, Xuc, Xue, Qxu^Bp|, Qxu^Bcx/, Qxu^Bcx/, Qxu^Bcx/, Qxu^Bcx/, Qxe, Qxe, Qxe, Qxe, Qxe, Qxe, Qxe, Qxe, Qxe, Uue, Uue, Uue, Qxe, Qxe, Qxe, Qxe, Qxe, Qxe
Qxe, Qxe, Qxe, Qxe, Qxe, Qxe, Qxe, Qxe, Qxe, Qxe, Qxe, Qxe, Qxe, Qxe, Qxe, Qxe, Qxe, Qxe, Qxe, Qxe, Qxe, Xue, Qxu^Bcx|, Qxu^Bcx/, Qxu^Bcx/, Qxu^Bcx/, Qxe, Qxe, Qxe, Qxe, Qxe, Qxe, Qxe, Qxe, Qxe, Qxe, Qxe, Qxe, Qxu^Bs|, Qxe, Qxe, Qxe, Qxe, Qxe, Qxe, Qxe
Qxe, Qxe, Qxe, Qxe, Qxe, Qxe, Qxe, Qxe, Qxe, Qxe, Qxe, Qxe, Qxe, Qxe, Qxe, Qxe, Qxe, Qxe, Qxe, Qxe, Qxe, Qxu^Bcx|, Qxu^Bcx|, Qxu^Bcx|, Qxe, Qxe, Qxe, Qxe, Qxe, Qxe, Qxe, Qxe, Qxe, Qxe, Qxe, Qxe, Qxe, Qxe, Qxu^Bs|, Qxe, Qxe, Qxe, Qxe, Qxe, Qxe, Qxe
Qxe, Qxe, Qxe, Qxe, Qxe, Qxe, Qxe, Qxe, Qxe, Qxe, Qxe, Qxe, Qxe, Qxe, Qxe, Qxe, Qxe, Qxe, Qxe, Qxe, Qxe, Qxu^Bcx|, Qxu^Bcx|, Qxu^Bcx|, Qxe, Qxe, Qxe, Qxe, Qxe, Qxe, Qxe, Qxe, Qxe, Qxe, Qxe, Qxe, Qxe, Qxe, Qxu^Bs|, Qxe, Qxe, Qxe, Qxe, Qxe, Qxe, Qxe
Qxe, Qxe, Qxe, Qxe, Qxe, Qxe, Qxe, Qxe, Qxe, Qxe, Qxe, Qxe, Qxe, Qxe, Qxe, Qxe, Uu^Vud, Qxe, Qxe, Qxe, Qxe, Qxu^Bcx|, Qxu^Bcx|, Qxu^Bcx|, Qxe, Qxe, Qxe, Qxe, Uu^Vud, Qxe, Qxe, Qxe, Qxe, Qxe, Qxe, Qxe, Qxe, Qxe, Qxu^Bs\, Qxe, Qxe, Qxe, Qxe, Qxe, Qxe, Qxe
Qxe, Qxe, Qxe, Qxe, Qxe, Qxe, Qxe, Qxe, Qxe, Qxe, Qxe, Qxe, Qxe, Qxe, Qxe, Cud, Kud, Cud, Qxe, Qxe, Qxe, Qxu^Bcx|, Qxu^Bcx|, Qxu^Bcx|, Qxe, Qxe, Qxe, Cud, Kud, Cud, Qxe, Qxe, Qxe, Qxe, Qxe, Qxe, Qxe, Qxe, Qxe, Qxu^Bs\, Qxu^Bs\, Qxe, Qxe, Qxe, Qxe, Qxe
Qxe, Qxe, Qxe, Qxe, Qxe, Qxe, Qxe, Qxe, Qxe, Qxe, Qxe, Qxe, Qxe, Qxe, Qxe, Ur^Emf, Cud, Ur, Qxu^Bcx\, Qxe, Qxe, Qxu^Bcx|, Qxu^Bcx|, Qxu^Bcx|, Qxe, Qxe, Qxu^Bcx/, Ur, Cud, Ur^Emf, Qxe, Qxe, Qxe, Qxe, Qxe, Qxe, Qxe, Qxe, Qxe, Qxe, Qxe, Qxu^Bs\, Qxu^Bs\, Qxe, Qxe, Qxe
Qxe, Qxe, Qxe, Qxe, Qxe, Qxe, Qxe, Qxe, Qxe, Qxe, Qxe, Qxe, Qxe, Qxe, Qxe, Qxe, Qxe, Qxe, Qxe, Qxu^Bcx\, Qxu^Bcx\, Uu^Vud, Qxu^Bcx|, Uu^Vud, Qxu^Bcx/, Qxu^Bcx/, Qxe, Qxe, Qxe, Qxe, Qxe, Qxe, Qxe, Qxe, Qxe, Qxe, Qxe, Qxe, Qxe, Qxe, Qxe, Qxe, Qxe, Qxu^Bs\, Qxu^Bs\, Qxe
Qxe, Qxe, Qxe, Qxe, Qxe, Qxe, Qxe, Qxe, Qxe, Qxe, Qxe, Qxe, Qxe, Qxe, Qxe, Qxe, Qxe, Qxe, Qxe, Qxe, Qxe, Qxu^Bcx\, Qxu^Bcx|, Qxu^Bcx/, Qxe, Qxe, Qxe, Qxe, Qxe, Qxe, Qxe, Qxe, Qxe, Qxe, Qxe, Qxe, Qxe, Qxe, Qxe, Qxe, Qxe, Qxe, Qxe, Qxe, Qxe, Qxu^Bs\
Qxe, Qxe, Qxe, Qxe, Qxe, Qxe, Qxe, Qxe, Qxe, Qxe, Qxe, Qxe, Qxe, Qxe, Qxe, Qxe, Qxe, Qxe, Qxe, Qxe, Qxe, Qxu^Bcx|, Qxu^Bcx|, Qxu^Bcx|, Qxe, Qxe, Qxe, Qxe, Qxe, Qxe, Qxe, Qxe, Qxe, Qxe, Qxe, Qxe, Qxe, Qxe, Qxe, Qxe, Qxe, Qxe, Qxe, Qxe, Qxe, Qxe
Qxe, Qxe, Qxe, Qxe, Qxe, Qxe, Qxe, Qxe, Qxe, Qxe, Qxe, Qxe, Qxe, Qxe, Qxe, Qxe, Qxe, Qxe, Qxe, Qxe, Qxe, Qxu^Bcx|, Qxu^Bcx|, Qxu^Bcx|, Qxe, Qxe, Qxe, Qxe, Qxe, Qxe, Qxe, Qxe, Qxe, Qxe, Qxe, Qxe, Qxe, Qxe, Qxe, Qxe, Qxe, Qxe, Qxe, Qxe, Qxe, Qxe
Qxe, Qxe, Qxe, Qxe, Qxe, Qxe, Qxe, Qxe, Qxe, Qxe, Qxe, Qxe, Qxe, Qxe, Qxe, Qxe, Qxe, Qxe, Qxe, Qxe, Qxe, Qxu^Bcx|, Qxu^Bcx|, Qxu^Bcx|, Qxe, Qxe, Qxe, Qxe, Qxe, Qxe, Qxe, Qxe, Qxe, Qxe, Qxe, Qxe, Qxe, Qxe, Qxe, Qxe, Qxe, Qxe, Qxe, Qxe, Qxe, Qxe
Qxe, Qxe, Qxe, Qxe, Qxe, Qxe, Qxe, Qxe, Qxe, Qxe, Qxe, Qxe, Qxe, Qxe, Qxe, Qxe, Qxe, Qxe, Qxe, Qxe, Qxe, Qxu^Bcx|, Qxu^Bcx|, Qxu^Bcx|, Qxe, Qxe, Qxe, Qxe, Qxe, Qxe, Qxe, Qxe, Qxe, Qxe, Qxe, Qxe, Qxe, Qxe, Qxe, Qxe, Qxe, Qxe, Qxe, Qxe, Qxe, Qxe
Qxe, Qxe, Qxe, Qxe, Qxe, Qxe, Qxe, Qxe, Qxe, Qxe, Qxe, Qxe, Qxe, Qxe, Qxe, Qxe, Qxe, Qxe, Qxe, Qxe, Qxe, Qxu^Bcx|, Ur, Qxu^Bcx|, Qxe, Qxe, Qxe, Qxe, Qxe, Qxe, Qxe, Qxe, Qxe, Qxe, Qxe, Qxe, Qxe, Qxe, Qxe, Qxe, Qxe, Qxe, Qxe, Qxe, Qxe, Qxe
Qxe, Qxe, Qxe, Qxe, Qxe, Qxe, Qxe, Qxe, Qxe, Qxe, Qxe, Qxe, Qxe, Qxe, Qxe, Qxe, Qxe, Qxe, Qxe, Qxe, Ur, Ur, Ur, Ur, Ur, Qxe, Qxe, Qxe, Qxe, Qxe, Qxe, Qxe, Qxe, Qxe, Qxe, Qxe, Qxe, Qxe, Qxe, Qxe, Qxe, Qxe, Qxe, Qxe, Qxe, Qxe
Uue, Qxe, Qxe, Qxe, Qxe, Qxe, Qxe, Qxe, Qxe, Qxe, Qxe, Qxe, Qxe, Qxe, Qxe, Qxe, Qxe, Qxe, Qxe, Qxe, Uu^Uf, Ur, Ur, Ur, Ur, Ur, Qxe, Qxe, Qxe, Qxe, Qxe, Qxe, Qxe, Qxe, Qxe, Qxe, Qxe, Qxe, Qxe, Qxe, Qxe, Qxe, Qxe, Qxe, Qxe, Qxe
Uue, Uue, Uue, Uue, Uue, Qxe, Qxe, Qxe, Qxe, Qxe, Qxe, Qxe, Qxe, Qxe, Qxe, Qxe, Qxe, Qxe, Qxe, Qxe, Xos, Ur, Ur, Ur, Ur, Ur, Qxe, Qxe, Qxe, Qxe, Qxe, Qxe, Qxe, Qxe, Qxe, Qxe, Qxe, Qxe, Qxe, Qxe, Qxe, Qxe, Qxe, Qxe, Qxe, Qxe
Uue, Uue, Uue, Uue, Uue, Uue, Qxe, Qxe, Qxe, Qxe, Qxe, Qxe, Qxe, Qxe, Qxe, Qxe, Qxe, Qxe, Qxe, Qxe, Xos, Urb, Urb, Urb, Urb, Xos, Qxe, Qxe, Qxe, Qxe, Qxe, Qxe, Qxe, Qxe, Qxe, Qxe, Qxe, Qxe, Qxe, Qxe, Xue, Xue, Qxe, Qxe, Qxe, Qxe
Uue, Uue, Uue, Uue, Uue, Uue, Qxe, Qxe, Qxe, Qxe, Qxe, Qxe, Qxe, Qxe, Qxe, Qxe, Qxe, Qxe, Qxe, Qxe, Xos, Urb, Urb, Urb, Urb, Xos, Qxe, Qxe, Qxe, Qxe, Qxe, Qxe, Qxe, Qxe, Qxe, Qxe, Qxe, Qxe, Uue, Xue, Qlf, Qlf, Qlf, Qxe, Qxe, Qxe
Uue, Uue, Uue, Uue, Uue, Uue, Qxe, Qxe, Qxe, Qxe, Qxe, Qxe, Qxe, Qxe, Qxe, Qxe, Qxe, Qxe, Qxe, Qxe, Xos, Urb, Urb, Urb, Urb, Xos, Qxe, Qxe, Qxe, Qxe, Qxe, Qxe, Qxe, Qxe, Qxe, Qxe, Qxe, Qxe, Qxe, Qlf, Qlf, Qlf, Qxe, Uu, Qxe, Qxe
Uue, Uue, Uue, Uue, Uue, Uue, Qxe, Qxe, Qxe, Qxe, Qxe, Qxe, Qxe, Qxe, Qxe, Qxe, Qxe, Qxe, Qxe, Qxe, Xos, Urb, Urb, Urb, Urb, Xos, Qxe, Qxe, Qxe, Qxe, Qxe, Qxe, Qxe, Qxe, Qxe, Qxe, Qxe, Qxe, Qxe, Qxe, Qxe, Xue, Qxe, Qxe, Qxe, Qxe
Uue, Uue, Uue, Uue, Uue, Uue, Qxe, Qxe, Qxe, Qxe, Qxe, Qxe, Qxe, Qxe, Qxe, Qxe, Qxe, Qxe, Qxe, Qxe, Xos, Urb, Urb, Urb, Urb, Xos, Qxe, Qxe, Qxe, Qxe, Qxe, Qxe, Qxe, Qxe, Qxe, Qxe, Qxe, Qxe, Qxe, Qxe, Qxe, Qxe, Qxe, Qxe, Qxe, Qxe
