border_size=1
usage=map

Uu, Uu, Uu, Uu, Uu, Uu, Uu, Uu, Uu, Uu, Uu, Uu, Uu, Uu, Uu, Uu, Xol, Xol, Xol, Xol, Xol, Xol, Urb, Urb, Urb, Xol, Xol, Xol, Xol, Xol, Xol, Uu, Uu, Uu, Uu^Em, Uu, Uu, Uu, Uu, Uu, Uu, Uu, Uu, Uu, Uu, Uu
Uu, Ce, Ce, Uu, Uu, Uu, Uu, Uu, Uu, Uu, Uu, Uu, Uu, Uu, Xol, Xol, Urb, Urb, Urb, Urb, Urb, Urb, Urb, Urb, Urb, Urb, Urb, Urb, Urb, Urb, Urb, Xol, Uu^Dr, Uu, Uu, Uu^Em, Uu, Uu, Uu, Uu, Uu, Ce, Ce, Ce, Ce, Uu
Uu, Ce, Ke, Ce, Ce, Uu, Uu, Uu^Vu, Uu, Uu, Uu, Uu, Xol, Xol, Urb, Urb, Urb, Urb, Urb, Urb, Urb, Urb, Urb, Urb, Urb, Urb, Urb, Urb, Urb, Urb, Urb, Urb, Urb, Xol, Xol, Uu, Uu, Uu^Vu, Uu, Uu, Uu, Ce, Ce, Ke, Ce, Uu
Uu, Ce, Ce, Ce, Uu, Uu, Uu, Uu, Uu, Uu, Uu^Dr, Xol, Urb, Urb, Urb, Urb, Urb, Urb, Urb, Urb, Urb, Urb, Urb, Urb, Urb, Urb, Urb, Urb, Urb, Urb, Urb, Urb, Urb, Urb, Urb, Xol, Xol, Uu, Uu, Uu, Uu, Ce, Ce, Ce, Uu^Em, Uu
Uu, Ce, Uu, Uu, Uu, Uu, Uu^Vu, Uu, Xol, Xol, Urb, Urb, Urb, Urb, Urb, Urb, Urb, Urb, Urb, Urb, Urb, Urb, Urb, Urb, Urb, Urb, Urb, Urb, Urb, Urb, Urb, Urb, Urb, Urb, Urb, Urb, Urb, Xol, Xol, Uu^Em, Uu, Uu, Uu^Vu, Ce, Uu, Uu
Uu, Uu, Uu, Uu^Vu, Uu, Uu, Xol, Xol, Urb, Urb, Urb, Urb, Urb, Urb, Urb, Urb, Urb, Urb, Urb, Urb, Urb, Urb, Urb, Urb, Urb, Urb, Urb, Urb, Urb, Urb, Urb, Urb, Urb, Urb, Urb, Urb, Urb, Urb, Urb, Uu^Dr, Xol, Uu, Uu, Uu, Uu, Uu
Uu, Uu, Uu, Uu, Xol, Uu^Dr, Urb, Urb, Urb, Urb, Urb, Uu^Vud, Urb, Urb, Urb, Urb, Urb, Urb, Urb, Urb, Urb, Urb, Urb, Urb, Urb, Urb, Urb, Urb, Urb, Urb, Urb, Urb, Urb, Urb, Urb, Urb, Urb, Urb, Urb, Urb, Urb, Xol, Uu^Dr, Uu, Uu, Uu
Uu, Uu, Xol, Xol, Urb, Urb, Urb, Urb, Urb, Urb, Urb, Urb, Urb, Urb, Urb, Urb, Urb, Urb, Urb, Urb, Urb, Uu^Vud, Urb, Urb, Urb, Urb, Urb, Urb, Uu^Vud, Urb, Urb, Urb, Urb, Urb, Urb, Urb, Urb, Urb, Urb, Urb, Urb, Urb, Urb, Xol, Xol, Uu
Xol, Xol, Urb, Urb, Urb, Urb, Urb, Urb, Urb, Urb, Urb, Urb, Urb, Urb, Urb, Urb, Urb, Urb, Urb, Urb, Urb, Urb, Urb, Urb, Urb, Urb, Urb, Urb, Urb, Urb, Urb, Urb, Urb, Urb, Urb, Urb, Urb, Urb, Urb, Urb, Urb, Urb, Urb, Urb, Urb, Xol
Xol, Urb, Urb, Urb, Urb, Urb, Urb, Urb, Urb, Urb, Urb, Urb, Urb, Urb, Urb, Urb, Urb, Urb, Urb, Urb, Urb, Urb, Urb, Urb, Urb, Urb, Urb, Urb, Urb, Urb, Urb, Urb, Urb, Urb, Urb, Urb, Urb, Urb, Urb, Urb, Urb, Urb, Urb, Urb, Urb, Xol
Xol, Urb, Urb, Urb, Urb, Urb, Urb, Urb, Urb, Urb, Urb, Urb, Urb, Urb, Urb, Urb, Cud, Cud, Cud, Urb, Urb, Urb, Urb, Urb, Urb, Urb, Cud, Cud, Cud, Urb, Urb, Urb, Urb, Urb, Urb, Urb, Urb, Urb, Urb, Urb, Urb, Urb, Urb, Urb, Urb, Xol
Xol, Urb, Urb, Urb, Urb, Urb, Urb, Urb, Urb, Urb, Urb, Urb, Urb, Urb, Urb, Urb, Cud, Kud, Cud, Urb, Urb, Urb, Urb, Urb, Urb, Urb, Cud, Kud, Cud, Urb, Urb, Urb, Urb, Urb, Urb, Urb, Urb, Urb, Urb, Urb, Urb, Urb, Urb, Urb, Urb, Xol
Xol, Urb, Urb, Urb, Urb, Urb, Urb, Urb, Urb, Urb, Urb, Urb, Urb, Urb, Urb, Urb, Urb, Cud, Urb, Urb, Urb, Urb, Cud, Urb, Urb, Urb, Urb, Cud, Urb, Urb, Urb, Urb, Urb, Urb, Urb, Urb, Urb, Urb, Urb, Urb, Urb, Urb, Urb, Urb, Urb, Xol
Xol, Urb, Urb, Urb, Urb, Urb, Urb, Urb, Urb, Urb, Urb, Urb, Urb, Urb, Uu^Vud, Urb, Urb, Urb, Urb, Urb, Cud, Cud, Cud, Cud, Cud, Urb, Urb, Urb, Urb, Urb, Urb, Urb, Urb, Urb, Urb, Urb, Urb, Urb, Urb, Urb, Urb, Urb, Urb, Urb, Urb, Xol
Xol, Urb, Urb, Urb, Urb, Urb, Urb, Urb, Urb, Urb, Urb, Urb, Urb, Urb, Urb, Urb, Urb, Urb, Cud, Cud, Cud, Cud, Cud, Cud, Cud, Cud, Cud, Urb, Urb, Urb, Urb, Urb, Urb, Urb, Urb, Urb, Urb, Urb, Urb, Urb, Urb, Urb, Urb, Urb, Urb, Xol
Xol, Urb, Urb, Urb, Urb, Urb, Urb, Urb, Urb, Urb, Urb, Urb, Urb, Urb, Urb, Urb, Urb, Cud, Cud, Cud, Cud, Cud, Cud, Cud, Cud, Cud, Cud, Cud, Urb, Urb, Urb, Urb, Urb, Urb, Urb, Urb, Urb, Uu^Vud, Urb, Urb, Urb, Urb, Urb, Urb, Urb, Xol
Xol, Urb, Urb, Urb, Urb, Urb, Urb, Urb, Urb, Urb, Urb, Urb, Urb, Urb, Urb, Urb, Urb, Cud, Cud, Cud, Cud, Cud, Cud, Cud, Cud, Cud, Cud, Cud, Urb, Urb, Urb, Urb, Urb, Urb, Urb, Urb, Urb, Urb, Urb, Urb, Urb, Urb, Urb, Urb, Urb, Xol
Xol, Urb, Urb, Urb, Urb, Urb, Urb, Urb, Urb, Urb, Urb, Urb, Urb, Urb, Urb, Urb, Urb, Cud, Cud, Cud, Cud, Cud, Kud, Cud, Cud, Cud, Cud, Cud, Urb, Urb, Urb, Urb, Urb, Urb, Urb, Urb, Urb, Urb, Urb, Urb, Urb, Urb, Urb, Urb, Urb, Xol
Xol, Urb, Urb, Urb, Urb, Urb, Urb, Urb, Urb, Urb, Urb, Urb, Urb, Urb, Urb, Urb, Urb, Cud, Cud, Cud, Cud, Cud, Cud, Cud, Cud, Cud, Cud, Cud, Urb, Urb, Urb, Urb, Urb, Uu^Vud, Urb, Urb, Urb, Urb, Urb, Urb, Urb, Urb, Urb, Urb, Urb, Xol
Xol, Urb, Urb, Urb, Urb, Urb, Urb, Urb, Urb, Urb, Urb, Urb, Uu^Vud, Urb, Urb, Urb, Urb, Cud, Cud, Cud, Cud, Cud, Cud, Cud, Cud, Cud, Cud, Cud, Urb, Urb, Urb, Urb, Urb, Urb, Urb, Urb, Urb, Urb, Urb, Urb, Urb, Urb, Urb, Urb, Urb, Xol
Xol, Urb, Urb, Urb, Uu^Vud, Urb, Urb, Urb, Urb, Urb, Urb, Urb, Urb, Urb, Urb, Urb, Urb, Cud, Cud, Cud, Cud, Cud, Cud, Cud, Cud, Cud, Cud, Cud, Urb, Urb, Urb, Urb, Urb, Urb, Urb, Urb, Urb, Urb, Urb, Urb, Urb, Urb, Urb, Urb, Urb, Xol
Xol, Urb, Urb, Urb, Urb, Urb, Urb, Urb, Urb, Urb, Urb, Urb, Urb, Urb, Urb, Urb, Urb, Urb, Urb, Cud, Cud, Cud, Cud, Cud, Cud, Cud, Urb, Urb, Urb, Urb, Urb, Urb, Urb, Urb, Urb, Urb, Urb, Urb, Urb, Urb, Urb, Urb, Urb, Urb, Urb, Xol
Xol, Urb, Urb, Urb, Urb, Urb, Urb, Urb, Urb, Urb, Urb, Urb, Urb, Urb, Urb, Urb, Urb, Urb, Urb, Urb, Urb, Cud, Cud, Cud, Urb, Urb, Urb, Urb, Urb, Urb, Urb, Urb, Urb, Urb, Urb, Urb, Urb, Urb, Urb, Urb, Urb, Urb, Urb, Urb, Urb, Xol
Xol, Urb, Urb, Urb, Urb, Urb, Urb, Urb, Urb, Urb, Urb, Urb, Urb, Urb, Urb, Urb, Cud, Cud, Cud, Urb, Urb, Urb, Urb, Urb, Urb, Urb, Cud, Cud, Cud, Urb, Urb, Urb, Urb, Urb, Urb, Urb, Urb, Urb, Urb, Urb, Urb, Urb, Urb, Urb, Urb, Xol
Uu, Xol, Xol, Urb, Urb, Urb, Urb, Urb, Urb, Urb, Urb, Urb, Urb, Urb, Urb, Urb, Cud, Kud, Cud, Urb, Urb, Urb, Urb, Urb, Urb, Urb, Cud, Kud, Cud, Urb, Urb, Urb, Urb, Urb, Urb, Uu^Vud, Urb, Urb, Urb, Urb, Urb, Urb, Urb, Urb, Xol, Xol
Uu, Uu, Uu, Xol, Xol, Urb, Urb, Urb, Urb, Urb, Urb, Urb, Urb, Urb, Urb, Urb, Urb, Cud, Urb, Urb, Urb, Urb, Urb, Urb, Urb, Urb, Urb, Cud, Urb, Urb, Urb, Urb, Urb, Urb, Urb, Urb, Urb, Urb, Urb, Urb, Urb^Es, Urb, Xol, Xol, Uu, Uu
Uu, Uu, Uu, Uu, Uu, Xol, Xol, Urb, Urb, Urb, Urb, Urb, Urb, Urb, Urb, Urb, Urb, Urb, Urb, Urb, Urb, Urb, Urb, Urb, Urb, Urb, Urb, Urb, Urb, Urb, Urb, Urb, Uu^Vud, Urb, Urb, Urb, Urb, Urb, Urb^Es, Urb^Es, Uu^Dr, Xol, Uu, Uu, Uu^Em, Uu
Uu, Uu, Uu, Uu, Uu, Uu, Uu, Xol, Uu^Dr, Urb, Urb, Urb, Urb, Urb, Urb, Urb, Urb, Urb, Urb, Urb, Urb, Urb, Urb, Urb, Urb, Urb, Urb, Urb, Urb, Urb, Urb, Urb, Urb, Urb, Urb, Urb, Urb, Urb, Xol, Uu^Dr, Uu, Uu, Uu, Uu, Uu, Uu
Uu, Uu, Uu^Vu, Uu^Em, Uu, Uu, Uu, Uu, Uu, Xol, Xol, Urb, Urb, Urb, Urb, Urb, Urb, Urb, Urb, Urb, Urb, Urb, Urb, Urb, Urb, Urb, Urb, Urb, Urb, Urb, Urb, Urb, Urb, Urb, Urb, Urb, Xol, Xol, Uu, Uu, Uu, Uu, Uu, Uu, Uu, Uu
Uu, Uu, Uu, Uu, Ket, Uu, Uu, Uu, Uu, Uu, Uu, Xol, Xol, Urb, Urb, Urb, Urb, Urb, Urb, Urb, Urb, Urb, Urb, Urb, Urb, Urb, Urb, Urb, Urb, Urb, Urb, Urb, Urb, Urb, Xol, Xol, Uu, Uu, Uu, Uu, Uu, Uu, Uu^Vu, Uu, Uu, Uu
Uu, Uu, Ket, Uu, Ce, Uu, Ket, Uu, Uu, Uu, Uu, Uu, Uu, Xol, Xol, Urb, Urb, Urb, Urb, Urb, Urb, Urb, Urb, Urb, Uu^Vud, Urb, Urb, Urb, Urb, Urb, Urb^Es, Urb^Es, Xol, Xol, Uu, Uu, Uu, Uu, Uu, Uu, Uu, Uu, Uu, Uu, Uu, Uu
Uu, Uu, Uu^Em, Ce, Ke, Ce, Uu, Uu, Uu, Uu, Uu, Uu, Uu, Uu, Uu, Xol, Xol, Urb, Urb, Urb, Urb, Urb, Urb, Urb, Urb, Urb, Urb, Urb, Urb, Urb, Xol, Uu^Dr, Uu, Uu, Uu, Uu, Uu, Uu, Uu, Uu, Uu, Ce, Ce, Ce, Uu, Uu
Uu, Uu, Ket, Ce, Ce, Ce, Ket, Uu, Uu^Vu, Uu, Uu, Uu, Uu, Uu^Em, Uu, Uu, Uu, Xos, Xos, Urb, Urb, Urb, Urb, Urb, Urb, Urb, Urb, Urb, Xol, Xol, Uu^Em, Uu, Uu, Uu, Uu, Uu, Uu, Uu, Uu, Uu, Ce, Ce, Ke, Ce, Uu, Uu
Uu, Uu, Uu, Uu, Ket, Uu, Uu, Uu, Uu, Uu, Uu, Uu, Uu, Uu, Uu, Uu^Vu, Uu, Uu, Uu^Em, Uu^Dr, Xos, Urb, Urb, Urb, Urb, Urb, Xol, Xol, Uu, Uu, Uu^Em, Uu, Uu, Uu, Uu, Uu^Vu, Uu, Uu, Uu, Uu, Uu, Ce, Ce, Ce, Uu, Uu
Uu, Uu, Uu, Uu, Uu, Uu, Uu, Uu, Uu, Uu, Uu, Uu, Uu, Uu, Uu, Uu, Uu, Uu, Uu, Uu, Uu, Xol, Urb, Urb, Urb, Xol, Uu, Uu, Uu, Uu, Uu, Uu, Uu, Uu, Uu, Uu, Uu, Uu, Uu, Uu, Uu, Uu, Uu, Uu, Uu, Uu
