border_size=1
usage=map

Xol, Xol, Urb, Xol, Xol, Xol, Xol, Xol, Xol, Xol, Xol, Xol, Xol, Xol, Xol, Xol, Xol, Xol, Xol, Xol, Xol, Xol, Xol, Xol, Xol, Xol, Xol, Xol, Xol, Xol, Xol, Xol, Xol, Xol, Xol, Xol, Xol, Xol, Xol, Xol, Xol, Xol, Xol, Xol, Xol, Xol, Xol, Xol, Xol, Xol, Xol, Xol, Xol, Xol, Xol, Xol, Xol, Xol, Xol
Xol, Xol, Xol, Urb, Urb, Xol, Xol, Xol, Xol, Xol, Xol, Xol, Urb, Urb, Urb, Xol, Xol, Xol, Xol, Xol, Xol, Xol, Xol, Xol, Xol, Xol, Xol, Xol, Xol, Xol, Xol, Xol, Xol, Xol, Xol, Xol, Xol, Xol, Xol, Xol, Xol, Xol, Xol, Xol, Xol, Xol, Xol, Xol, Xol, Xol, Xol, Xol, Xol, Xol, Xol, Xol, Xol, Xol, Xol
Xol, Xol, Xol, Xol, Xol, Urb, Urb, Xol, Xol, Xol, Urb, Urb, Urb, Urb, Urb, Urb, Urb, Xol, Xol, Xol, Xol, Xol, Xol, Xol, Xol, Xol, Xol, Xol, Xol, Xol, Xol, Xol, Xol, Xol, Xol, Xol, Xol, Xol, Xol, Xol, Xol, Xol, Xol, Xol, Xol, Xol, Xol, Xol, Xol, Xol, Xol, Xol, Xol, Xol, Xol, Xol, Xol, Xol, Xol
Xol, Xol, Xol, Xol, Xol, Xol, Xol, Urb, Urb, Urb, Urb, Urb, Urb, Urb, Urb, Urb, Urb, Urb, Urb, Xol, Xol, Xol, Xol, Xol, Xol, Xol, Xol, Xol, Xol, Xol, Xol, Xol, Xol, Xol, Xol, Xol, Xol, Xol, Xol, Xol, Xol, Xol, Xol, Xol, Xol, Xol, Xol, Xol, Xol, Xol, Xol, Xol, Xol, Xol, Xol, Xol, Xol, Xol, Xol
Xol, Xol, Xol, Xol, Xol, Xol, Urb, Urb, Urb, Urb, Urb, Urb, Ch, Ch, Ch, Urb, Urb, Urb, Urb, Urb, Urb, Xol, Xol, Xol, Xol, Xol, Xol, Xol, Xol, Xol, Xol, Xol, Xol, Xol, Xol, Xol, Xol, Xol, Xol, Xol, Xol, Xol, Xol, Xol, Xol, Xol, Xol, Xol, Xol, Xol, Xol, Xol, Xol, Xol, Xol, Xol, Xol, Xol, Xol
Xol, Xol, Xol, Xol, Xol, Urb, Urb, Urb, Urb, Urb, Urb, Urb, Ch, Kh, Ch, Urb, Urb, Urb, Urb, Urb, Urb, Urb, Urb, Xol, Xol, Xol, Xol, Xol, Xol, Xol, Xol, Xol, Xol, Xol, Xol, Xol, Xol, Xol, Xol, Xol, Xol, Xol, Xol, Xol, Xol, Xol, Xol, Xol, Xol, Xol, Xol, Xol, Xol, Xol, Xol, Xol, Xol, Xol, Xol
Xol, Xol, Xol, Xol, Xol, Xol, Xol, Urb, Urb, Urb, Urb, Urb, Urb, Ch, Urb, Urb, Urb, Urb, Urb, Urb, Urb, Urb, Urb, Urb, Urb, Xol, Xol, Xol, Xol, Xol, Xol, Xol, Xol, Xol, Xol, Xol, Xol, Xol, Xol, Xol, Xol, Xol, Xol, Xol, Xol, Xol, Xol, Xol, Xol, Xol, Xol, Xol, Xol, Xol, Xol, Xol, Xol, Xol, Xol
Xol, Xol, Xol, Xol, Xol, Xol, Xol, Xol, Xol, Urb, Urb, Urb, Urb, Urb, Urb, Urb, Urb, Urb, Urb, Urb, Urb, Urb, Urb, Urb, Urb, Urb, Urb, Xol, Xol, Xol, Xol, Xol, Xol, Xol, Xol, Xol, Xol, Xol, Xol, Xol, Xol, Xol, Xol, Xol, Xol, Xol, Xol, Xol, Xol, Xol, Xol, Xol, Xol, Xol, Xol, Xol, Xol, Xol, Xol
Xol, Xol, Xol, Xol, Xol, Xol, Xol, Xol, Xol, Xol, Xol, Urb, Urb, Urb, Urb, Urb, Urb, Urb, Urb, Urb, Urb, Urb, Urb, Urb, Urb, Urb, Urb, Urb, Urb, Xol, Xol, Xol, Xol, Xol, Xol, Xol, Xol, Xol, Xol, Xol, Xol, Xol, Xol, Xol, Xol, Xol, Xol, Xol, Xol, Xol, Xol, Xol, Xol, Xol, Xol, Xol, Xol, Xol, Xol
Xol, Xol, Xol, Xol, Xol, Xol, Xol, Xol, Xol, Xol, Xol, Xol, Xol, Urb, Urb, Urb, Urb, Urb, Urb, Urb, Urb, Urb, Urb, Urb, Urb, Urb, Urb, Urb, Xol, Xol, Xol, Xol, Xol, Xol, Xol, Xol, Xol, Xol, Xol, Xol, Xol, Xol, Xol, Xol, Xol, Xol, Xol, Xol, Xol, Xol, Xol, Xol, Xol, Xol, Xol, Xol, Xol, Xol, Xol
Xol, Xol, Xol, Xol, Xol, Xol, Xol, Xol, Xol, Xol, Xol, Xol, Xol, Xol, Xol, Urb, Urb, Urb, Urb, Urb, Urb, Urb, Urb, Urb, Urb, Urb, Xol, Xol, Xol, Xol, Xol, Xol, Xol, Xol, Xol, Xol, Xol, Xol, Xol, Xol, Xol, Xol, Xol, Xol, Xol, Xol, Xol, Xol, Xol, Xol, Xol, Xol, Xol, Xol, Xol, Xol, Xol, Xol, Xol
Xol, Xol, Xol, Xol, Xol, Xol, Xol, Xol, Xol, Xol, Xol, Xol, Xol, Xol, Xol, Xol, Xol, Urb, Urb, Urb, Urb, Urb, Urb, Urb, Xol, Xol, Xol, Xol, Xol, Xol, Xol, Xol, Xol, Xol, Xol, Xol, Xol, Xol, Xol, Xol, Xol, Xol, Xol, Xol, Xol, Xol, Xol, Xol, Xol, Xol, Xol, Xol, Xol, Xol, Xol, Xol, Xol, Xol, Xol
Xol, Xol, Xol, Xol, Xol, Xol, Xol, Xol, Xol, Xol, Xol, Xol, Xol, Xol, Xol, Xol, Urb, Urb, Xol, Urb, Urb, Urb, Xol, Xol, Xol, Xol, Xol, Xol, Xol, Xol, Xol, Xol, Urb, Urb, Urb, Xol, Xol, Xol, Xol, Xol, Xol, Xol, Xol, Xol, Xol, Xol, Xol, Xol, Xol, Xol, Xol, Xol, Xol, Xol, Xol, Xol, Xol, Xol, Xol
Xol, Xol, Xol, Xol, Xol, Xol, Xol, Xol, Xol, Xol, Xol, Xol, Xol, Xol, Urb, Urb, Xol, Xol, Xol, Xol, Xol, Xol, Xol, Xol, Xol, Xol, Xol, Xol, Xol, Xol, Xol, Xol, Urb, Xol, Xol, Urb, Urb^Xo, Xol, Urb, Xol, Xol, Xol, Xol, Xol, Xol, Xol, Xol, Xol, Xol, Xol, Xol, Xol, Xol, Xol, Xol, Xol, Xol, Xol, Xol
Xol, Xol, Xol, Xol, Xol, Xol, Xol, Xol, Xol, Xol, Xol, Xol, Urb, Urb, Xol, Xol, Xol, Xol, Xol, Xol, Xol, Xol, Xol, Xol, Xol, Xol, Xol, Xol, Xol, Xol, Xol, Xol, Urb, Xol, Xol, Xol, Urb, Urb, Urb, Urb, Urb, Xol, Xol, Xol, Xol, Xol, Xol, Xol, Xol, Xol, Xol, Xol, Xol, Xol, Xol, Xol, Xol, Xol, Xol
Xol, Xol, Xol, Xol, Xol, Xol, Xol, Xol, Xol, Xol, Urb, Urb, Xol, Xol, Xol, Xol, Xol, Xol, Xol, Xol, Xol, Xol, Xol, Xol, Xol, Xol, Xol, Xol, Xol, Xol, Xol, Xol, Urb, Xol, Xol, Xol, Xol, Urb, Urb, Urb, Xol, Xol, Xol, Xol, Xol, Xol, Xol, Xol, Xol, Xol, Xol, Xol, Xol, Xol, Xol, Xol, Xol, Xol, Xol
Xol, Xol, Xol, Xol, Xol, Xol, Xol, Xol, Xol, Xol, Xol, Urb, Urb, Xol, Xol, Xol, Xol, Xol, Xol, Xol, Xol, Xol, Xol, Xol, Xol, Xol, Xol, Xol, Xol, Xol, Xol, Xol, Urb, Xol, Xol, Xol, Xol, Xol, Xol, Xol, Xol, Xol, Xol, Xol, Xol, Xol, Xol, Xol, Xol, Xol, Xol, Xol, Xol, Xol, Xol, Xol, Xol, Xol, Xol
Xol, Xol, Xol, Xol, Xol, Xol, Xol, Xol, Xol, Xol, Xol, Xol, Xol, Urb, Urb, Xol, Xol, Xol, Urb, Xol, Xol, Xol, Xol, Xol, Xol, Xol, Xol, Xol, Xol, Xol, Xol, Xol, Urb, Xol, Xol, Xol, Xol, Xol, Xol, Xol, Xol, Xol, Xol, Xol, Xol, Xol, Xol, Xol, Xol, Xol, Xol, Xol, Xol, Xol, Xol, Xol, Xol, Xol, Xol
Xol, Xol, Xol, Xol, Xol, Xol, Xol, Xol, Xol, Xol, Xol, Xol, Xol, Xol, Xol, Urb, Urb, Urb, Urb, Urb, Xol, Xol, Xol, Xol, Xol, Xol, Xol, Xol, Xol, Xol, Xol, Xol, Urb, Xol, Xol, Xol, Xol, Xol, Xol, Xol, Xol, Xol, Xol, Xol, Xol, Xol, Xol, Xol, Xol, Xol, Xol, Xol, Xol, Xol, Xol, Xol, Xol, Xol, Xol
Xol, Xol, Xol, Xol, Xol, Xol, Xol, Xol, Xol, Xol, Xol, Xol, Xol, Xol, Xol, Xol, Xol, Urb, Urb, Urb, Xol, Xol, Xol, Xol, Xol, Xol, Xol, Xol, Urb, Urb, Urb, Xol, Urb, Xol, Xol, Xol, Xol, Xol, Xol, Xol, Xol, Xol, Xol, Xol, Xol, Xol, Xol, Xol, Xol, Xol, Xol, Xol, Xol, Xol, Xol, Xol, Xol, Xol, Xol
Xol, Xol, Xol, Xol, Xol, Xol, Xol, Xol, Xol, Xol, Xol, Xol, Xol, Xol, Xol, Xol, Xol, Urb, Urb, Urb, Urb, Xol, Xol, Xol, Xol, Xol, Urb, Urb, Xol, Xol, Xol, Urb, Urb, Xol, Xol, Xol, Xol, Xol, Xol, Xol, Xol, Xol, Xol, Xol, Xol, Xol, Xol, Xol, Xol, Xol, Xol, Xol, Xol, Xol, Xol, Xol, Xol, Xol, Xol
Xol, Xol, Xol, Xol, Xol, Xol, Xol, Xol, Xol, Xol, Xol, Xol, Xol, Xol, Xol, Xol, Xol, Urb, Xol, Urb, Xol, Urb, Urb, Xol, Urb, Urb, Xol, Xol, Xol, Xol, Xol, Xol, Urb, Xol, Xol, Xol, Xol, Xol, Xol, Xol, Xol, Xol, Xol, Xol, Xol, Xol, Xol, Xol, Xol, Xol, Xol, Xol, Xol, Xol, Xol, Xol, Xol, Xol, Xol
Xol, Xol, Xol, Xol, Xol, Xol, Xol, Xol, Xol, Xol, Xol, Xol, Xol, Xol, Xol, Xol, Xol, Xol, Xol, Xol, Xol, Xol, Xol, Urb, Xol, Xol, Xol, Xol, Xol, Xol, Xol, Xol, Urb, Xol, Xol, Xol, Xol, Xol, Xol, Xol, Xol, Xol, Xol, Xol, Xol, Xol, Xol, Xol, Xol, Xol, Xol, Xol, Xol, Xol, Xol, Xol, Xol, Xol, Xol
Xol, Xol, Xol, Xol, Xol, Xol, Xol, Xol, Xol, Xol, Xol, Xol, Xol, Xol, Xol, Xol, Xol, Xol, Xol, Xol, Xol, Xol, Xol, Xol, Xol, Xol, Xol, Xol, Xol, Xol, Xol, Xol, Urb, Xol, Xol, Xol, Xol, Xol, Xol, Xol, Xol, Xol, Xol, Xol, Xol, Xol, Xol, Xol, Xol, Xol, Xol, Xol, Xol, Xol, Xol, Xol, Xol, Xol, Xol
Xol, Xol, Xol, Xol, Xol, Xol, Xol, Xol, Xol, Xol, Xol, Xol, Xol, Xol, Xol, Xol, Xol, Xol, Xol, Xol, Xol, Xol, Xol, Xol, Xol, Xol, Xol, Xol, Xol, Xol, Xol, Xol, Urb, Xol, Xol, Xol, Xol, Xol, Xol, Xol, Xol, Xol, Xol, Xol, Xol, Xol, Xol, Xol, Xol, Xol, Xol, Xol, Xol, Xol, Xol, Xol, Xol, Xol, Xol
Xol, Xol, Xol, Xol, Xol, Xol, Xol, Xol, Xol, Xol, Xol, Xol, Xol, Xol, Xol, Xol, Xol, Xol, Xol, Xol, Xol, Xol, Xol, Xol, Xol, Xol, Xol, Xol, Xol, Xol, Urb, Xol, Urb, Xol, Urb, Xol, Xol, Xol, Xol, Xol, Xol, Xol, Xol, Xol, Xol, Xol, Xol, Xol, Xol, Xol, Xol, Xol, Xol, Xol, Xol, Xol, Xol, Xol, Xol
Xol, Xol, Xol, Xol, Xol, Xol, Xol, Xol, Xol, Xol, Xol, Xol, Xol, Xol, Xol, Xol, Xol, Xol, Xol, Xol, Xol, Xol, Xol, Xol, Xol, Xol, Xol, Xol, Xol, Urb, Urb, Xol, Urb, Xol, Urb, Urb, Xol, Xol, Xol, Xol, Xol, Xol, Xol, Xol, Xol, Xol, Xol, Xol, Xol, Xol, Xol, Xol, Xol, Xol, Xol, Xol, Xol, Xol, Xol
Xol, Xol, Xol, Xol, Xol, Xol, Xol, Xol, Xol, Xol, Xol, Xol, Xol, Xol, Xol, Xol, Xol, Xol, Xol, Xol, Xol, Xol, Xol, Xol, Xol, Xol, Xol, Xol, Xol, Uu^Vud, Urb, Urb, Urb, Urb, Urb, Urb, Xol, Xol, Xol, Xol, Xol, Xol, Xol, Xol, Xol, Xol, Xol, Xol, Xol, Xol, Xol, Xol, Xol, Xol, Xol, Xol, Xol, Xol, Xol
Xol, Xol, Xol, Xol, Xol, Xol, Xol, Xol, Xol, Xol, Xol, Xol, Xol, Xol, Xol, Xol, Xol, Xol, Xol, Xol, Xol, Xol, Xol, Xol, Xol, Xol, Xol, Xol, Xol, Xol, Xol, Urb, Urb, Urb, Xol, Xol, Xol, Xol, Xol, Xol, Xol, Xol, Xol, Xol, Xol, Xol, Xol, Xol, Xol, Xol, Xol, Xol, Xol, Xol, Xol, Xol, Xol, Xol, Xol
Xol, Xol, Xol, Xol, Xol, Xol, Xol, Xol, Xol, Xol, Xol, Xol, Xol, Xol, Xol, Xol, Xol, Xol, Xol, Xol, Xol, Xol, Xol, Xol, Xol, Xol, Xol, Xol, Xol, Xol, Xol, Xol, Urb, Xol, Xol, Xol, Xol, Xol, Xol, Xol, Xol, Xol, Xol, Xol, Xol, Xol, Xol, Xol, Xol, Xol, Xol, Xol, Xol, Xol, Xol, Xol, Xol, Xol, Xol
Xol, Xol, Xol, Xol, Xol, Xol, Xol, Xol, Xol, Xol, Xol, Xol, Xol, Xol, Xol, Xol, Xol, Xol, Xol, Xol, Xol, Xol, Xol, Xol, Xol, Xol, Xol, Xol, Xol, Xol, Xol, Xol, Urb, Xol, Xol, Xol, Xol, Xol, Xol, Xol, Xol, Xol, Xol, Xol, Xol, Xol, Xol, Xol, Xol, Xol, Xol, Xol, Xol, Xol, Xol, Xol, Xol, Xol, Xol
Xol, Xol, Xol, Xol, Xol, Xol, Xol, Xol, Xol, Xol, Xol, Xol, Xol, Xol, Xol, Xol, Xol, Xol, Xol, Xol, Xol, Xol, Xol, Xol, Xol, Xol, Xol, Xol, Xol, Xol, Xol, Xol, Urb, Xol, Xol, Xol, Xol, Xol, Xol, Xol, Xol, Xol, Xol, Xol, Xol, Xol, Xol, Xol, Xol, Xol, Xol, Xol, Xol, Xol, Xol, Xol, Xol, Xol, Xol
Xol, Xol, Xol, Xol, Xol, Xol, Xol, Xol, Xol, Xol, Xol, Xol, Xol, Xol, Xol, Xol, Xol, Xol, Xol, Xol, Xol, Xol, Xol, Xol, Xol, Xol, Xol, Xol, Xol, Xol, Xol, Xol, Urb, Xol, Xol, Xol, Xol, Xol, Xol, Xol, Xol, Xol, Xol, Xol, Xol, Xol, Xol, Xol, Xol, Xol, Xol, Xol, Xol, Xol, Xol, Xol, Xol, Xol, Xol
Xol, Xol, Xol, Xol, Xol, Xol, Xol, Xol, Xol, Xol, Xol, Xol, Xol, Xol, Xol, Xol, Xol, Xol, Xol, Xol, Xol, Xol, Xol, Xol, Xol, Xol, Xol, Xol, Xol, Xol, Xol, Xol, Urb, Xol, Xol, Xol, Xol, Xol, Xol, Xol, Xol, Xol, Xol, Xol, Xol, Xol, Xol, Xol, Xol, Xol, Xol, Xol, Xol, Xol, Xol, Xol, Xol, Xol, Xol
Xol, Xol, Xol, Xol, Xol, Xol, Xol, Xol, Xol, Xol, Xol, Xol, Xol, Xol, Xol, Xol, Xol, Xol, Xol, Xol, Xol, Xol, Xol, Xol, Xol, Xol, Xol, Xol, Xol, Xol, Xol, Xol, Urb, Xol, Xol, Xol, Xol, Xol, Xol, Xol, Xol, Xol, Xol, Xol, Xol, Xol, Xol, Xol, Xol, Xol, Xol, Xol, Xol, Xol, Xol, Xol, Xol, Xol, Xol
Xol, Xol, Xol, Xol, Xol, Xol, Xol, Xol, Xol, Xol, Xol, Xol, Xol, Xol, Xol, Xol, Xol, Xol, Xol, Xol, Xol, Xol, Xol, Xol, Xol, Xol, Xol, Xol, Xol, Xol, Xol, Xol, Urb, Xol, Xol, Xol, Xol, Xol, Xol, Xol, Xol, Xol, Xol, Xol, Xol, Xol, Xol, Xol, Xol, Xol, Xol, Xol, Xol, Xol, Xol, Xol, Xol, Xol, Xol
Xol, Xol, Xol, Xol, Xol, Xol, Xol, Xol, Xol, Xol, Xol, Xol, Xol, Xol, Xol, Xol, Xol, Xol, Xol, Xol, Xol, Xol, Xol, Xol, Xol, Xol, Xol, Xol, Xol, Xol, Xol, Xol, Xol, Urb, Urb, Xol, Xol, Xol, Xol, Xol, Xol, Xol, Xol, Xol, Xol, Xol, Xol, Xol, Xol, Xol, Xol, Xol, Xol, Xol, Xol, Xol, Xol, Xol, Xol
Xol, Xol, Xol, Xol, Xol, Xol, Xol, Xol, Xol, Xol, Xol, Xol, Xol, Xol, Xol, Xol, Xol, Xol, Xol, Xol, Xol, Xol, Xol, Xol, Xol, Xol, Xol, Xol, Xol, Xol, Xol, Xol, Xol, Xol, Xol, Urb, Urb, Xol, Xol, Xol, Xol, Xol, Xol, Xol, Xol, Xol, Xol, Xol, Xol, Xol, Xol, Xol, Xol, Xol, Xol, Xol, Xol, Xol, Xol
Xol, Xol, Xol, Xol, Xol, Xol, Xol, Xol, Xol, Xol, Xol, Xol, Xol, Xol, Xol, Xol, Xol, Xol, Xol, Xol, Xol, Xol, Xol, Xol, Xol, Xol, Xol, Xol, Xol, Xol, Xol, Xol, Xol, Xol, Xol, Xol, Urb, Urb, Urb, Xol, Xol, Xol, Xol, Xol, Xol, Xol, Xol, Xol, Xol, Xol, Xol, Xol, Xol, Xol, Xol, Xol, Xol, Xol, Xol
Xol, Xol, Xol, Xol, Xol, Xol, Xol, Xol, Xol, Xol, Xol, Xol, Xol, Xol, Xol, Xol, Xol, Xol, Xol, Xol, Xol, Xol, Xol, Xol, Xol, Xol, Xol, Xol, Xol, Xol, Xol, Xol, Xol, Xol, Urb, Urb, Urb, Urb, Urb, Urb, Urb, Xol, Xol, Xol, Xol, Xol, Xol, Xol, Xol, Xol, Xol, Xol, Xol, Xol, Xol, Xol, Xol, Xol, Xol
Xol, Xol, Xol, Xol, Xol, Xol, Xol, Xol, Xol, Xol, Xol, Xol, Xol, Xol, Xol, Xol, Xol, Xol, Xol, Xol, Xol, Xol, Xol, Xol, Xol, Xol, Xol, Xol, Xol, Xol, Xol, Xol, Xol, Xol, Uu^Vud, Urb, Urb, Urb, Urb, Urb, Urb, Xol, Xol, Xol, Xol, Xol, Xol, Xol, Xol, Xol, Xol, Xol, Xol, Xol, Xol, Xol, Xol, Xol, Xol
Xol, Xol, Xol, Xol, Xol, Xol, Xol, Xol, Xol, Xol, Xol, Xol, Xol, Xol, Xol, Xol, Xol, Xol, Xol, Xol, Xol, Xol, Xol, Xol, Xol, Xol, Xol, Xol, Xol, Xol, Xol, Xol, Xol, Xol, Urb, Urb, Urb, Urb, Urb, Urb, Urb, Xol, Xol, Xol, Xol, Xol, Xol, Xol, Xol, Xol, Xol, Xol, Xol, Xol, Xol, Xol, Xol, Xol, Xol
Xol, Xol, Xol, Xol, Xol, Xol, Xol, Xol, Xol, Xol, Xol, Xol, Xol, Xol, Xol, Xol, Xol, Xol, Urb, Xol, Xol, Xol, Xol, Xol, Xol, Xol, Xol, Xol, Xol, Xol, Xol, Xol, Xol, Xol, Xol, Urb, Urb, Urb, Urb, Urb, Xol, Xol, Xol, Xol, Xol, Xol, Xol, Xol, Xol, Xol, Xol, Xol, Xol, Xol, Xol, Xol, Xol, Xol, Xol
Xol, Xol, Xol, Xol, Xol, Xol, Xol, Xol, Xol, Xol, Xol, Xol, Xol, Xol, Xol, Xol, Urb, Urb, Urb, Urb, Xol, Xol, Xol, Xol, Xol, Xol, Xol, Xol, Xol, Xol, Xol, Xol, Xol, Xol, Xol, Xol, Xol, Urb, Xol, Xol, Xol, Xol, Xol, Xol, Xol, Xol, Xol, Xol, Xol, Xol, Xol, Xol, Xol, Xol, Xol, Xol, Xol, Xol, Xol
Xol, Xol, Xol, Xol, Xol, Xol, Xol, Xol, Xol, Xol, Xol, Xol, Xol, Xol, Xol, Urb, Urb, Urb, Urb^Xo, Xol, Xol, Xol, Xol, Xol, Xol, Xol, Xol, Xol, Xol, Xol, Xol, Xol, Xol, Xol, Xol, Xol, Xol, Urb, Xol, Xol, Xol, Xol, Xol, Xol, Xol, Xol, Xol, Xol, Xol, Xol, Xol, Xol, Xol, Xol, Xol, Xol, Xol, Xol, Xol
Xol, Xol, Xol, Xol, Xol, Xol, Xol, Xol, Xol, Xol, Xol, Xol, Xol, Xol, Xol, Xol, Xol, Xol, Xol, Urb, Urb, Xol, Xol, Xol, Xol, Xol, Xol, Xol, Xol, Xol, Xol, Xol, Xol, Xol, Xol, Xol, Xol, Urb, Xol, Xol, Xol, Xol, Xol, Xol, Xol, Xol, Xol, Xol, Xol, Xol, Xol, Xol, Xol, Xol, Xol, Xol, Xol, Xol, Xol
Xol, Xol, Xol, Xol, Xol, Xol, Xol, Xol, Xol, Xol, Xol, Xol, Xol, Xol, Xol, Xol, Xol, Xol, Xol, Xol, Xol, Urb, Urb, Xol, Xol, Xol, Xol, Xol, Xol, Xol, Xol, Xol, Xol, Xol, Xol, Xol, Xol, Urb, Xol, Xol, Xol, Xol, Xol, Xol, Xol, Xol, Urb, Urb, Urb, Xol, Xol, Xol, Xol, Xol, Xol, Xol, Xol, Xol, Xol
Xol, Xol, Xol, Xol, Xol, Xol, Xol, Xol, Xol, Xol, Xol, Xol, Xol, Xol, Xol, Xol, Xol, Xol, Xol, Xol, Xol, Xol, Xol, Urb, Urb, Xol, Xol, Xol, Xol, Xol, Xol, Xol, Xol, Xol, Xol, Xol, Urb, Urb, Xol, Xol, Xol, Xol, Xol, Xol, Xol, Xol, Urb, Uu^Vud, Urb, Xol, Xol, Xol, Xol, Xol, Xol, Xol, Xol, Xol, Xol
Xol, Xol, Xol, Xol, Xol, Xol, Xol, Xol, Xol, Xol, Xol, Xol, Xol, Xol, Xol, Xol, Xol, Xol, Xol, Xol, Xol, Xol, Xol, Xol, Xol, Urb, Urb, Xol, Xol, Xol, Xol, Xol, Xol, Xol, Urb, Urb, Xol, Xol, Xol, Xol, Xol, Xol, Xol, Xol, Xol, Xol, Urb, Urb, Urb, Xol, Xol, Xol, Xol, Xol, Xol, Xol, Xol, Xol, Xol
Xol, Xol, Xol, Xol, Xol, Xol, Xol, Xol, Xol, Xol, Xol, Xol, Xol, Xol, Xol, Xol, Xol, Xol, Xol, Xol, Xol, Xol, Xol, Xol, Xol, Xol, Xol, Urb, Urb, Xol, Xol, Xol, Urb, Urb, Xol, Xol, Xol, Xol, Xol, Xol, Xol, Xol, Xol, Xol, Urb, Urb, Xol, Urb, Xol, Urb, Urb, Xol, Xol, Xol, Xol, Xol, Xol, Xol, Xol
Xol, Xol, Xol, Xol, Xol, Xol, Xol, Xol, Xol, Xol, Xol, Xol, Xol, Xol, Xol, Xol, Xol, Xol, Xol, Xol, Xol, Xol, Xol, Xol, Xol, Xol, Xol, Xol, Urb, Urb, Urb, Urb, Xol, Xol, Xol, Xol, Xol, Xol, Xol, Xol, Xol, Xol, Xol, Xol, Urb, Xol, Xol, Urb, Xol, Xol, Urb, Xol, Xol, Xol, Xol, Xol, Xol, Xol, Xol
Xol, Xol, Xol, Xol, Xol, Xol, Xol, Xol, Xol, Xol, Xol, Xol, Xol, Xol, Xol, Xol, Xol, Xol, Xol, Xol, Xol, Xol, Xol, Xol, Xol, Xol, Xol, Xol, Urb, Urb, Xol, Xol, Xol, Xol, Xol, Xol, Xol, Xol, Xol, Xol, Xol, Xol, Xol, Xol, Urb, Xol, Xol, Xol, Xol, Xol, Urb, Xol, Xol, Xol, Xol, Xol, Xol, Xol, Xol
Xol, Xol, Xol, Xol, Xol, Xol, Xol, Xol, Xol, Xol, Xol, Xol, Xol, Xol, Xol, Xol, Xol, Xol, Xol, Xol, Xol, Xol, Xol, Xol, Xol, Xol, Urb, Urb, Xol, Xol, Xol, Xol, Xol, Xol, Xol, Xol, Xol, Xol, Xol, Xol, Xol, Xol, Xol, Xol, Urb, Xol, Xol, Xol, Xol, Xol, Urb, Xol, Xol, Xol, Xol, Xol, Xol, Xol, Xol
Xol, Xol, Xol, Xol, Xol, Xol, Xol, Xol, Xol, Xol, Xol, Xol, Xol, Xol, Xol, Xol, Xol, Xol, Xol, Xol, Xol, Xol, Xol, Xol, Xol, Urb, Xol, Xol, Xol, Xol, Xol, Xol, Xol, Xol, Xol, Xol, Xol, Xol, Xol, Xol, Xol, Xol, Xol, Xol, Urb, Xol, Xol, Xol, Xol, Xol, Urb, Xol, Xol, Xol, Xol, Xol, Xol, Xol, Xol
Xol, Xol, Xol, Xol, Xol, Xol, Xol, Xol, Xol, Xol, Xol, Xol, Xol, Xol, Xol, Xol, Xol, Xol, Xol, Xol, Xol, Xol, Xol, Xol, Xol, Urb, Urb, Xol, Xol, Xol, Urb, Xol, Xol, Xol, Xol, Xol, Xol, Xol, Xol, Xol, Xol, Xol, Xol, Xol, Urb, Xol, Xol, Xol, Xol, Xol, Urb, Xol, Xol, Xol, Xol, Xol, Xol, Xol, Xol
Xol, Xol, Xol, Xol, Xol, Xol, Xol, Xol, Xol, Xol, Xol, Xol, Xol, Xol, Xol, Xol, Xol, Xol, Xol, Xol, Xol, Xol, Xol, Xol, Urb, Urb, Urb, Urb, Urb, Urb, Xol, Urb, Urb, Xol, Xol, Xol, Xol, Xol, Xol, Xol, Xol, Xol, Xol, Xol, Urb, Xol, Xol, Xol, Xol, Xol, Urb, Xol, Xol, Xol, Xol, Xol, Xol, Xol, Xol
Xol, Xol, Xol, Xol, Xol, Xol, Xol, Xol, Xol, Xol, Xol, Xol, Xol, Xol, Xol, Xol, Xol, Xol, Xol, Xol, Xol, Xol, Xol, Urb, Urb, Urb, Urb, Urb, Urb, Urb, Urb, Xol, Xol, Urb, Urb, Xol, Xol, Xol, Xol, Xol, Xol, Xol, Urb, Urb, Xol, Xol, Xol, Xol, Xol, Xol, Urb, Xol, Xol, Xol, Xol, Xol, Xol, Xol, Xol
Xol, Xol, Xol, Xol, Xol, Xol, Xol, Xol, Xol, Xol, Xol, Xol, Xol, Xol, Xol, Xol, Xol, Xol, Xol, Xol, Xol, Xol, Xol, Xol, Xol, Urb, Urb, Urb, Urb, Urb, Urb, Urb, Xol, Xol, Xol, Urb, Urb, Xol, Xol, Xol, Urb, Urb, Xol, Xol, Xol, Xol, Xol, Xol, Xol, Xol, Urb, Urb, Urb, Xol, Xol, Xol, Xol, Xol, Xol
Xol, Xol, Xol, Xol, Xol, Xol, Xol, Xol, Xol, Xol, Xol, Xol, Xol, Xol, Xol, Xol, Xol, Xol, Xol, Xol, Xol, Xol, Xol, Xol, Xol, Xol, Xol, Urb, Urb, Urb, Xol, Xol, Xol, Xol, Xol, Xol, Xol, Urb, Urb, Urb, Xol, Xol, Xol, Xol, Xol, Xol, Xol, Xol, Xol, Xol, Urb, Xol, Xol, Urb, Urb^Xo, Xol, Xol, Xol, Xol
Xol, Xol, Xol, Xol, Xol, Xol, Xol, Xol, Xol, Xol, Xol, Xol, Xol, Xol, Xol, Xol, Xol, Xol, Xol, Xol, Xol, Xol, Xol, Xol, Xol, Xol, Xol, Xol, Xol, Xol, Xol, Xol, Xol, Xol, Xol, Xol, Xol, Xol, Xol, Xol, Xol, Xol, Xol, Xol, Xol, Xol, Xol, Xol, Urb, Xol, Urb, Xol, Xol, Xol, Urb, Urb, Urb, Xol, Xol
Xol, Xol, Xol, Xol, Xol, Xol, Xol, Xol, Xol, Xol, Xol, Xol, Xol, Xol, Xol, Xol, Xol, Xol, Xol, Xol, Xol, Xol, Xol, Xol, Xol, Xol, Xol, Xol, Xol, Xol, Xol, Xol, Urb, Urb, Xol, Xol, Xol, Xol, Xol, Xol, Xol, Xol, Xol, Xol, Xol, Xol, Xol, Urb, Urb, Urb, Urb, Xol, Xol, Xol, Xol, Urb, Xol, Xol, Xol
Xol, Xol, Xol, Xol, Xol, Xol, Xol, Xol, Xol, Xol, Xol, Xol, Xol, Xol, Xol, Xol, Xol, Xol, Xol, Xol, Xol, Xol, Xol, Xol, Xol, Xol, Xol, Xol, Xol, Xol, Xol, Urb, Urb, Urb, Xol, Xol, Xol, Xol, Xol, Xol, Xol, Xol, Xol, Xol, Xol, Xol, Urb, Urb, Xol, Urb, Xol, Xol, Xol, Xol, Xol, Xol, Xol, Xol, Xol
Xol, Xol, Xol, Xol, Xol, Xol, Xol, Xol, Xol, Xol, Xol, Xol, Xol, Xol, Xol, Xol, Xol, Xol, Xol, Xol, Xol, Xol, Xol, Xol, Xol, Xol, Xol, Xol, Xol, Xol, Xol, Xol, Xol, Urb^Xo, Xol, Xol, Xol, Xol, Xol, Xol, Xol, Xol, Xol, Xol, Urb, Urb, Xol, Xol, Xol, Xol, Xol, Xol, Xol, Xol, Xol, Xol, Xol, Xol, Xol
Xol, Xol, Xol, Xol, Xol, Xol, Xol, Xol, Xol, Xol, Xol, Xol, Xol, Xol, Xol, Xol, Xol, Xol, Xol, Xol, Xol, Xol, Xol, Xol, Xol, Xol, Xol, Xol, Xol, Xol, Xol, Xol, Urb, Urb, Urb, Xol, Xol, Xol, Xol, Xol, Xol, Xol, Urb, Urb, Xol, Xol, Xol, Xol, Xol, Xol, Xol, Xol, Xol, Xol, Xol, Xol, Urb, Urb, Xol
Xol, Xol, Xol, Xol, Xol, Xol, Xol, Xol, Xol, Xol, Xol, Xol, Xol, Xol, Xol, Xol, Xol, Xol, Xol, Xol, Xol, Xol, Xol, Xol, Xol, Xol, Xol, Xol, Xol, Xol, Xol, Xol, Xol, Urb, Xol, Xol, Xol, Xol, Xol, Xol, Urb, Urb, Xol, Xol, Xol, Xol, Xol, Xol, Xol, Xol, Xol, Xol, Xol, Xol, Urb, Urb, Xol, Xol, Xol
Xol, Xol, Xol, Xol, Xol, Xol, Xol, Xol, Xol, Xol, Xol, Xol, Xol, Xol, Xol, Xol, Xol, Xol, Xol, Xol, Xol, Xol, Xol, Xol, Xol, Xol, Xol, Xol, Xol, Xol, Xol, Xol, Xol, Urb, Xol, Xol, Xol, Xol, Xol, Urb, Urb, Xol, Xol, Xol, Xol, Xol, Xol, Xol, Xol, Xol, Xol, Xol, Urb, Urb, Urb^Xo, Xol, Xol, Xol, Xol
Xol, Xol, Xol, Xol, Xol, Xol, Xol, Xol, Xol, Xol, Xol, Xol, Xol, Xol, Xol, Xol, Xol, Xol, Xol, Xol, Xol, Xol, Xol, Xol, Xol, Xol, Xol, Xol, Xol, Xol, Xol, Xol, Xol, Urb, Xol, Xol, Xol, Xol, Xol, Xol, Urb, Urb, Urb, Xol, Xol, Xol, Xol, Xol, Xol, Xol, Urb, Urb, Xol, Xol, Urb, Urb, Urb, Xol, Xol
Xol, Xol, Xol, Xol, Xol, Xol, Xol, Xol, Xol, Xol, Xol, Xol, Xol, Xol, Xol, Xol, Xol, Xol, Xol, Xol, Xol, Xol, Xol, Xol, Xol, Xol, Xol, Xol, Xol, Xol, Xol, Xol, Xol, Urb, Urb, Xol, Xol, Xol, Urb, Urb, Xol, Xol, Xol, Urb, Urb, Xol, Xol, Xol, Urb, Urb, Xol, Xol, Xol, Urb, Urb, Urb, Xol, Xol, Xol
Xol, Xol, Xol, Xol, Xol, Xol, Xol, Xol, Xol, Xol, Xol, Xol, Xol, Xol, Xol, Xol, Xol, Xol, Xol, Xol, Xol, Xol, Xol, Xol, Xol, Xol, Xol, Xol, Xol, Xol, Xol, Xol, Xol, Xol, Xol, Urb, Urb, Urb, Xol, Xol, Xol, Xol, Xol, Urb, Urb, Urb, Urb, Urb, Xol, Xol, Xol, Xol, Xol, Xol, Xol, Xol, Xol, Xol, Xol
Xol, Xol, Xol, Xol, Xol, Xol, Xol, Xol, Xol, Xol, Xol, Xol, Xol, Xol, Xol, Xol, Xol, Xol, Xol, Xol, Xol, Xol, Xol, Xol, Xol, Xol, Xol, Xol, Xol, Xol, Xol, Xol, Xol, Xol, Xol, Xol, Xol, Xol, Xol, Xol, Xol, Xol, Uu^Vud, Urb, Xol, Urb, Xol, Xol, Xol, Xol, Xol, Xol, Xol, Xol, Xol, Xol, Xol, Xol, Xol
Xol, Xol, Xol, Xol, Xol, Xol, Xol, Xol, Xol, Xol, Xol, Xol, Xol, Xol, Xol, Xol, Xol, Xol, Xol, Xol, Xol, Xol, Xol, Xol, Xol, Xol, Xol, Xol, Xol, Xol, Xol, Xol, Xol, Xol, Xol, Xol, Xol, Xol, Xol, Xol, Xol, Xol, Xol, Xol, Xol, Xol, Xol, Xol, Xol, Xol, Xol, Xol, Xol, Xol, Xol, Xol, Xol, Xol, Xol
